QPXF
Level 6
12 21
0,1,1,1,0,0,0,0,0,0,0,0,0,0,0,0,0,1,1,1,1
0,1,0,0,1,1,1,1,1,1,1,1,1,1,1,1,1,0,0,0,1
1,1,0,0,0,0,0,0,0,0,0,0,0,0,0,0,0,0,0,0,1
1,3,0,0,0,0,0,0,0,0,0,0,0,0,0,0,0,0,0,0,1
1,1,0,0,0,0,0,0,0,0,0,0,0,0,0,0,0,0,0,0,1
0,1,0,0,0,0,0,0,0,0,0,0,0,0,0,0,0,0,2,2,1
0,1,2,2,0,0,0,0,0,0,0,0,1,0,0,2,0,0,1,1,1
0,1,2,2,2,0,0,0,0,0,0,0,1,4,2,2,2,0,1,0,0
0,1,2,2,2,2,0,0,0,0,0,0,1,1,1,1,1,0,1,0,0
0,1,1,1,1,1,0,0,0,0,1,1,1,0,0,0,1,1,1,0,0
0,0,0,0,0,1,0,0,0,2,1,0,0,0,0,0,0,0,0,0,0
0,0,0,0,0,1,1,0,1,1,1,0,0,0,0,0,0,0,0,0,0
0,0,0,0,0,0,1,1,1,0,0,0,0,0,0,0,0,0,0,0,0
